11111111111111111111111111111
10E100000000000C0000000000001
10000101001000001000CC0010101
11111100101010100000CC0010111
1P0000000C00C00000000000000C1
11111111111111111111111111111