1111111111111111111111111111111111
1C0000000000000C00000C000000000101
1110010100100000100100000000010101
1010010010101010001E10000000010111
1P0000000C00C000000000000000000CC1
1111111111111111111111111111111111