111111111
10000001
1EPC100C1
111111111