1111111
1000101
1PEC1C1
1111111