1111111111111111111
11PCCCCCCCCCCCCE111
1111111111111111111
