1111111111111111111
1111111111111111111
1P1111111E000000001
1011111111111110011
1011111111111100111
1011111111111001111
1000000111110011111
1111110111100111111
1111110111001111111
1111110110011111111
1111110CCC00000C001
1111111111111111111
