1111111
10001C1
1PE0011
1111111