1111111
1000101
1PEC101
1111111